111111111111111
1010100C0101001
100001011000101
110100001010101
101101100010101
100C00001010101
E0010000C000001
100010101010101
10000000100P101
111111111111111