1111111111111111111
1000C10000110000001
100C000P00000000001
100C0000000C0000001
1011100000000000001
1E10000C0000000C001
1111111111111111111