111111111111
1C010C0C00P1
10C00110C101
1C0011EC1001
111111111111